NO ./textures/casino2.xpm
WE ./textures/casino4.xpm
SO ./textures/casino3.xpm
EA ./textures/casino1.xpm

C 174,164,164
F 64,64,64

111111111111111111111111111111111
10000000000D000000110000000000001
111111111011000001110000000000001
        1001000000D00000000000001
111111111011000001110000000000001
10000000001100000111D111111111111
11110111111111011100000010001
11110111111111D11101010010001
11000000110101011100000010001
100000000D000000D0000000D0001
10000000010000001001010010001
11000001110101011111011110N01
11110111 1110101 101111010001
11111111 1111111 111111111111