F          64,         64,        64


NO        ./textures/casino2.xpm


WE       ./textures/casino4.xpm
SO        ./textures/casino3.xpm


C      174,       164,       164


EA         ./textures/casino1.xpm

111111111111111111111111111111111
100000000000000000110000000000001
111111111011000001110000000000001
        1001000000000000000000001
111111111011000001110000000000001
100000000011000001110111111111111
11110111111111011100000010001
11110111111111011101010010001
11000000110101011100000010001
10000000000000000000000000001
10000000000000000001010010001
11000001110101011111011110N01
11110111 1110101 101111010001
11111111 1111111 111111111111