EA ./textures/kotik_new_1.xpm
NO ./textures/kotik_new_2.xpm
SO ./textures/kotik_new_3.xpm
WE ./textures/kotik_new_4.xpm

F 255,102,255
C 0,100,100

      1       1
      11     11
      111111111
     11000000011
    1100000000011
    10001111111111
 11110011        1
110010011        1
110010001111111111
11000000000000001
11000000000000001
11000000000000001
1100100000W000001
11001000000000001
 1111000011110001
    100001 100001
    100001 100001
    100001 100001
    111111 111111