EA ./textures/cotik.xpm
NO ./textures/image1.xpm
SO ./textures/image2.xpm
WE ./textures/image3.xpm

F 255,102,255
C 0,100,100


      111111111
     11000000011
    1100000000011111
111110000000000000001
10000000000000000011
1000000000000000001
10000000000000000011
110010000000000000001
110010000000000011111
11001000000000001
11001000001000001
11001000000000001
 1111000011110001
    100001 100001
    100001 100001
    100001 111111
    100001 100001
    100001 100001
    110001 111111
    100001 100001
    100001 100001
    100001 111111
    100001 100001
    100001 100001
    100001 111111
    100001 100001
    100001 100001
    110001 111111
    100001 100001
    100001 100001
    100001 111111
    100001 100001
    100001 100001
    100001 111111
    100001 100001
    100001 100001
    110001 111111
    100111 100001
    1001W1 100001
    111111 111111