NO ./textures/graffiti_1.xpm
SO ./textures/graffiti_2.xpm
WE ./textures/graffiti_3.xpm
EA ./textures/graffiti_4.xpm

F 20,20,20
C 200,200,200

 1111111
100000001
10111111
100000001
 11111101
100000001
10111111
100000001
 11111101
1N0000001
 1111111