EA ./textures/east.xpm
NO ./textures/test.xpm
SO ./textures/empty.xpm
WE ./textures/wall.xpm

F 1,0,1
C 100,100,100


      111111111
     11000000011
    1100000000011
    10001111111111
 11110011        1
110010011        1
110010001111111111
11001000000000001
11001000000000001
1100100000W000001
11001000000000001
11001000000000001
 1111000011110001
    100001 100001
    100001 100001
    111111 111111
