NO ./textures/north_32.xpm
SO ./textures/south_32.xpm
WE ./textures/west_32.xpm
EA ./textures/east_32.xpm

F 20,20,20
C 200,200,200

1111111111111
1000000000001
1011111111111
1000000000001
1011111111111
1000000000001
1011111111111
1000000000001
1111111111101
1N00000000001
1111111111111