EA ./textures/wall_3_128.xpm
NO ./textures/wall_2_128.xpm
SO ./textures/wall_1_128.xpm
WE ./textures/wall_0_128.xpm

F 255,102,255
C 0,100,100


      111111111
     11000000011
    1100000000011
    10001111111111
 11110011        1
110010011        1
110010001111111111111
110010000000000000001
110010000000000011111
1100100000S000001
11001000001000001
11001000000000001
 1111000011110001
    100001 100001
    100001 100001
    111111 111111
